2 5 0 1 4 0 6 8 9 
0 0 8 9 0 6 2 0 5 
6 7 9 2 5 8 1 4 3 
3 1 2 5 8 4 7 0 0 
0 8 0 7 9 0 5 3 2 
5 9 7 0 6 2 8 1 0 
7 2 4 0 1 3 0 5 8 
8 6 5 4 7 9 3 0 1 
9 3 1 8 2 5 4 0 0 

