**########################################################################################
#*######################*******************************************#####*************#####
#************************####*####################################*#####*###########*#####
#########*#########*#########*#######***************************##*#####*###########*#####
#******##*#########*#########*#######*#########################*##*#####*###########*#####
#*####*##*#########*#########*#######*#########################*##*#####********####*#####
#*####*##*#########*######*******####*###**********####****####*##*############*####*#####
#*##***#**#########*#################*###*########*####*#######*##*############*####*#####
#*##*###*##########*##############****###*******##*####*#######*##*##*****#####*####*#####
#*##*###*##########*##############*############*##*####*#######*##*##*###*#####*####*#####
#************######*##############**************##*####*#######*##*##*###*#####*####*#####
###################*##############################*####***#####*##*##*###*#####*####*#####
###################********************************############*##*##*###*#####*####*#####
###############################################################*##*##*###*#####*####*#####
###***************************************************#########*##*##*###*#####*####*#####
###*#################################################*#########*##*######*#####*####*#####
###*####*****#####**********************#############*#########*##********#####*####*#####
###*####*###*#####*####################***************#########*###############*####*#####
###*####*###*#####*############################################*****************####*#####
###******###*#####*#################################################################*#####
############*#####*******************************************************************#####
###**********#############################################################################
###*#########*****************************************************************############
###*#########*###############################################*############################
###*#########*###############################################*######*****************#####
###**************************************************########*######*#####################
#############################################################*######*#####################
#############################################################*######*#####################
#########################*****************************************************************
